11111111111111
10000000000001
11111110000001
10000001000001
10111110P00001
10100000000001
10000000E00001
11111111111111