11111111111111
10CP0000000001
11111110000001
10000C00C00011
10111110000001
10100101000111
10100101C1E111
11000101C01101
11111111111111